0000000000
0001111100
0111222100
0124212110
0121223210
0123221210
0114122210
0015221110
0011111000
0000000000