000000000000000000000
000001111100000000000
000001222100000000000
000001422100000000000
000111224110000000000
000122424210000000000
011121211210001111110
012221211211111223310
012422422222522223310
011111211121111223310
000001222221001111110
000001111111000000000
000000000000000000000