00000000000
00111110000
00122211110
00122212210
00112222310
01112111310
01242101310
01244101110
01522100000
01111100000
00000000000