00000000000
01111100000
01222111110
01242122210
01222141210
01114222210
00122211110
00125333100
00111111100
00000000000